---X----
------X-
--XP---X
---X----
-X------
X---C--X
------X-
------X-
X--C---X
-X------
-X------
X---C--X
------X-
----X---
X--C-X--
-X------
--------
--------