---X----
--------
---P----
-X----X-
X----C-X
--------
--------
-C------
--X--C-X
---X--X-
--------
----X---
X--C-X--
-X------
--------
--------
--------
--------