--X-----
-X----X-
X------X
--X-----
---X----
--X-C--X
------X-
-C----X-
--X--C-X
---X----
---X----
--X-C--X
X---X-X-
-X--X---
---X----
--------
--------
--------