----X---
-X------
X---PX--
----X---
------X-
X--C---X
-X------
-X------
X---C--X
------X-
------X-
X--C---X
-X------
---X----
--X-C--X
------X-
--------
--------
