---X----
--------
---P----
--------
--------
--------
-----X--
-C--X---
---X----
--------
-----C--
---X----
--X---X-
-----X--
--------
--------
--------
--------