----X---
--------
----P---
--------
--------
--------
--X-----
---X--C-
----X---
--------
--C-----
----X---
-X---X--
--X-----
--------
--------
--------
--------